############################################################
#         ## N #  ##   #####   ##   ##  ###   #   #        #
#   ###   ##___#       ##### ZZ##   ##        #   \  V     #
#   ###        #  ##   #####        \   ###   #   #   ######
#   ########   #  ##   #####  ########  ###   #   #XX      #
#       P ##   #####          ###   ##  ###   #   #   ##   #
#   ########      Y    #####  ###       ###       #   ##   E
############################################################