############################################################
#   #############                                ##   ##  ## 
#   #          ##   ######   ##   ##   #######   ##   ##  ## 
#   #   ####   ##        #   ##   ##   ##        ##        E 
#   #   ####   #######   #   ##   ##   ##  ###   ####   #### 
#       # N\             #             ##               #### 
############################################################