############################################################
#         ## N #       #####   ##   ##        #            #
#   ###   ##   #  ##           ##   ##  ###   #   #   ##   #
#              #  ##   #####      T \         #   #   ######
#   ########   #  ##   #####  ########  ###   #   #        #
#         ##   #####          ###   ##  ###   #   #   ##   #
#   ########           ####   ###       ###       #   ##   E
############################################################