############################################################
###     ###        #                                       #
#       ###        #   #############   #####################
#                T \   #####################################
#       ###        #   #####################               E
###     ###        #                           #############
############################################################