###################################################################
#     P ##      \   ##            \     ###          ###          #
#   ######   ####   ##   ####   #####         ####         ####   #
#       ##   #      ##   ####   #############################     #
#####   ##   #   #####   ####   ##                              ###
#  \    ##   #      ##   ####   ##   ##############################
#   ######   ####   ##   ####   ##                        ##      #
#            #      ##          ##   #   ###   ########   ##   ####
##############   #####   ########    #         ##   #             #
#                #####          #   ##   ########   ###########   #
#   ##################   ####   #   ##              #             #
#                    #   ####   #   ##################   ##########
#   ####   ##   ##   #          #   ##               #            #
#          ##   ##   #   ########   ####   ##   ##   ##########   #
#############   ##   #     ##########      ##   ##                #
#                    ###   #            ###########################
#   ###   ############     #   ###############         ####       #
#   ###        \    ##   ###   ####        \     ###   ####   #   #
#         #######        ###          ##############          #   #
################################################################E##