                                                                                    
                                                                                    
																	  	            
                 ###################################################################
                 # P   #        X  #        #          ##   ##       ## YY     #####
                 ###       #   #   \   ##   X   ####   #         #   ##   ##  Y#####
                 ##    #####   #   ####     #      #   ## YY######   ##   ##     ###
                 ##YY ###    Y #      #   ######   #        ##      X   YY####   ###
                 ##   ######   ####   #      X     #   #######    #####   #  \   ###
                 ##       ##      #   ##################                  #   Y#####
                 ##   #########   ####   X           ###     ##############      ###
                 #  YY#       #          #########   #       ##            ###   ###
                 #    #   #   ##   ##   ##   \       ##########  X   ##     X    ###
                 #    X   #   ##        ## Y ##########              ###############
                 ##########   ## YY#######         ##YY   #############   X      ###
                 #         X  ##        X   Y###   ##   ##   X       ##    ###     #
                 ###   ##########   #   #   ##     ##   ##    ####   ##   #      ###
                 ###   ###      #   #   #    #   ###    ##   #       ##  Y#   ######
                 #       #   #      #   ##   #     \   ###   #   ######   #      ###
                 #   #   \   ########        #   ###       Y #      X     ####   ###
                 #  ##################################################   #####   ###
                 #            Y    X   \    T   \             Y    X     #####   ###
                 #        X         Y  \        \     Y     X            ##### D ###
                 ##############################################################E####