############################################################
###     ###        #                    X                  #
#       ###        #  Y#############   #######   ###########
#  P               \   #####################################
#       ###        #Y  #####################     T D       E
###     ###        #                           #############
############################################################