############################################################
#   ##   ##         #######         ###   ##      #   ## E #
#        ##   ###   ##         ##   ###   #####       ##   #
#   ##   ########   #####   #####   ###   	  #   ##   #
#   ##   #####         ##      ##   ###   #########   ##   #
#        ##      ###   ##   #####   ###       ##      ##   #
#   ##########   ###   ##   ##      #######   ##   #####   #
#                      ##   #####   ###       ##########   #
#   #   ######   ########   ## N    ###   #          ###   #
#####   ##                  #####         ########   ###   #
#       ######   #############      ###         ##         #
############################################################