##E#########################################################
#            ##      #######          ####       ###       #
##########   #####      #######   #   ##     #         #   #
###               ###             #   ####   ####   ####   #
###############   ##########   ####   #         #   #      #
#                 ######   #   ##      #   ######   ####   #
#   ###########   ##   #        ####   #   ##       #      #
#   ###########   ##   ###   #####     #   ##   #####   ####
#                 #    ###   #   #   ###   ######   #      #
#########   #######   ##     #   #     #   #        #   ####
#           #         ##   ###   ###       #   ##   #      #
#   #########   ###   ##   #     ###########   ##   ####   #
#        ####   ##    ######   #########        #          #
######   ####   ##   #######   #       #   ##   #####   ####
#         ##         #   #         #   #   ##       #      #
#   ###   ##   ###   #   #   #######   #   ##   #   ####   #
#              #             #             ##   #          #
############################################################