############################################################
###     ###        #                                       #
#       ###        #   #####################################
#                T \   #####################################
#       ###        #   #####################               E
###     ###        #                           #############
############################################################