############################################################
#     ##   ########            #########                 ###
###   ##   ####   ##########   #########   ###########   ###
##    ##              ##             ###   ### N         ###
##   ##########   #   ######   ###   ###   ###########   ###
##   ###          #   ######         ###           ###   ###
##         ####               ###          ############ ####
#######################################################E####