############################################################
#                  V                        V              #
#   ###########################  W### W ##########   ###   #
#      #  ######      X     ###   ###   ##########   ###   #
####   #       #  ##   ##   ###         ##########   ###   #
#      #  ##   #  ##   ##   ###   ###################### YY#
#   ####  ##   #  ##   ##   ###   ####                     #
#         ##  ##  ##   ##___##########   ####   ##   ###   #
# P ########      ##   ##   ## N                ##   ###   #
##########################E#################################