############################################################
###     ###        #                                       #
#       ###        #   #####################################
# P              T \   #####################################
#       ###        #   #####################               E
###     ###        #                           #############
############################################################