############################################################
###     ###        #                   Y                   #
#       ###        #   #############   #####################
#  P             T \   #####################################
#       ###        #X X#####################               E
###     ###        #                           #############
############################################################