#################################################################
#     #           #        #          ##   ##       ##        ###
###       #   #       ##       ####   #         #   ##   ##   ###
##    #####   #   ####     #      #   ##   ######   ##   ##     #
##   ###      #      #   ######   #        ##            ####   #
##   ######   ####   #            #   #######    #####   #      #
##       ##      #   ##################                  #   ####
##   #########   ####               ####    ##############      #
#    #       #          #########   #       ##           ####   #
#   ##   #   ##   ##   ##           #############   ##          #
#        #   ##        ##   ##########              #############
##########   ##   #######         ##     #############          #
#            ##             ###   ##   ##           ##   ####   #
###   ##########   #   #   ##     ##   ##   #####   ##   #      #
###   ###      #   #   #    #   ###    ##   #       ##   #   ####
#       #   #      #   ##   #     #   ###   #   ######   #      #
#   #       ########        #   ###         #            ####   #
##############################################################E##