############################################################
# P ####              ##        ####         #            ##
#      #   #   ####   ##   ##   ####   ###       ##   #   ##
####       #   ####   ##   ##      #   ##    ######   #    #
#      #####      #   ##    ########   #    #         ##   #
#   ###############   ###   ####       #   #############   #
#        #       ##          ##    #####   #######         #
#   ##   #   #########   #######   ##      ##        #######
#        #   ##      #             ##   #####   #######    E
#   ######   ##   ####   ####   #######################    #
#            #       #                 ##        #######   #
##   #########   #   #   #######   #        ##         #   #
##   ##          #   #       ###   ###      ##   ###   #   #
#         #   ####   #####            ###    #   ###   #   #
#   #######   #          ####   ###      #    ####         #
############################################################