############################################################
# P #############            Y                   ##   ##  ## 
#   #          ## X ######   ##   ##   #######   ##   ##  ## 
#   #   ####   ##        #   ##   ##   ##        ##        E 
#   #   ####   #######   #   ##   ##   ##  ###   ####   #### 
#       # N\             #           Y ##      Z        #### 
############################################################