############################################################
###     ###        #                    X                  #
#       ###        #   #############   #######   ###########
#  P               \   #####################################
#       ###        #Y Y#####################     T D       E
###     ###        #                           #############
############################################################