############################################################
# P   ##   ########           ##########                 ###
###   ##   ####   ##########  ##########   ###########   ###
##    ##              ##             ###   ### N     \   ###
##   ##########   #   ######  ###    ###   ###########   ###
##   ###          #   ### ##         ###           ###   ###
##         ####               ###          ############ ####
#######################################################E####