############################################################
#   ##   ##         #######         ###   ##      #   ## E #
#        ##   ###   ##         ##   ###   #####       ##   #
#   ##   ########   #####   #####   ###           #   ##   #
#   ##   #####         ##      ##   ###   #########   ##   #
#        ##      ###   ##   #####   ###       ##      ##   #
#   ##########   ###   ##   ##      #######   ##   #####   #
#                      ##   #####   ###       ##########   #
#   #   ######   ########   ## N    ###   #          ###   #
#####   ##                  #####         ########   ###   #
# P     ######   #############      ###         ##         #
############################################################