                                                                              
                                                                              
                                                                              
                  ############################################################
                  ###     ###        #                    X                T #
                  #       ###        #  Y#############   #######   ###########
                  #  P               \   #####################################
                  #       ###        #Y  #####################       D       E
                  ###     ###        #                           #############
                  ############################################################