############################################################
###     ###        #                                       #
#       ###        #   #############   #####################
#  P             T \   #####################################
#       ###        #   #####################               E
###     ###        #                           #############
############################################################