############################################################
# P #############                                ##   ##  ## 
#   #          ##   ######   ##   ##   #######   ##   ##  ## 
#   #   ####   ##        #   ##   ##   ##        ##        E 
#   #   ####   #######   #   ##   ##   ##  ###   ####   #### 
#       # N\             #             ##               #### 
############################################################