############################################################
#         ## N #       #####   ##   ##        #            #
#   ###   ##   #  ##           ##   ##  ###   #   #   ##   #
#              #  ##   #####      T \         #   #   ######
#   ########   #  ##   #####  ########  ###   #   #        #
#       P ##   #####          ###   ##  ###   #   #   ##   #
#   ########           ####   ###       ###       #   ##   E
############################################################