############################################################
#                                                          #
#   ###########################   ###   ##########   ###   #
#      #  ######            ###   ###   ##########   ###   #
####   #       #  ##   ##   ###         ##########   ###   #
#      #  ##   #  ##   ##   ###   ######################   #
#   ####  ##   #  ##   ##   ###   ####                     #
#         ##  ##  ##   ##___##########   ####   ##   ###   #
#   ########      ##   ##   ## N                ##   ###   #
##########################E#################################